＊初期化
＄NOTIFYの自動保存	有効
＄スコープ切り換え時	
＄さくらスクリプトによるスコープ切り換え時	
＄選択肢開始時	\![*]
＄タイマ変数はセーブしない	有効
＄サーフェス加算値0	0
＄サーフェス加算値1	0
＄デフォルトサーフェス0	1
＄デフォルトサーフェス1	10
＄会話時サーフェス戻し	有効
＄自動セーブ間隔	300
＄自動挿入ウェイトの倍率	０％
＄自動挿入ウェイトタイプ	無効
＄喋り間隔	１８０秒
＄喋り間隔誤差	１０％
＄見切れてても喋る	有効
＄現在のラジオ局	太陽協会ニュース
＄現在の時間帯	朝
＄中央_季節	春
＄北部_季節	春
＄南部_季節	春
＄東部_季節	春
＄西部_季節	春
＄中央_天気	晴れ
＄北部_天気	晴れ
＄南部_天気	晴れ
＄東部_天気	晴れ
＄西部_天気	晴れ
＄soundscapes_talk_count	0
＄soundscapes_current_title	虚ろな響き
＄メニュー閉じるフラグ	0
